13	19
32	32
0	1	1	1	1	1	1	1	1	1	1	1	1	2	3	1	1	1	1	
0	1	1	1	1	1	1	1	2	3	4	5	1	1	1	1	1	1	4	
0	1	1	1	1	1	1	1	1	1	6	1	1	4	5	1	1	7	1	
0	1	1	1	1	1	1	1	1	7	1	1	1	1	1	1	1	4	5	
0	1	1	1	1	8	1	1	1	8	1	2	3	1	1	1	1	1	1	
0	1	1	1	1	1	1	1	1	1	1	1	1	1	1	1	1	1	1	
0	1	1	1	1	1	1	1	1	1	1	1	1	1	1	1	1	1	1	
0	1	1	1	1	1	1	1	1	1	1	1	1	1	1	1	1	1	1	
0	1	1	9	10	11	1	1	1	1	12	13	1	1	1	1	1	1	1	
0	1	1	14	15	16	1	1	1	1	1	1	1	1	1	1	17	18	19	
0	1	1	1	1	1	1	1	20	21	19	1	1	1	22	23	24	25	26	
27	28	29	30	1	1	1	22	31	32	26	33	34	35	36	37	38	25	26	
39	40	41	42	43	44	45	46	47	48	49	50	51	52	53	54	55	56	57	
