7	104
64	64
35	35	35	35	52	53	53	53	54	55	55	56	57	53	53	58	35	52	54	55	55	56	53	58	35	35	35	35	35	35	35	35	35	35	35	35	35	35	52	53	53	53	53	54	55	55	55	56	53	57	53	53	53	54	55	59	25	25	25	25	30	30	30	30	30	30	30	30	30	30	30	30	16	25	30	30	30	30	25	30	16	30	30	30	30	25	25	25	16	30	30	16	30	30	25	25	25	25	25	25	60	61	62	63
41	42	42	42	43	30	30	30	25	30	30	25	44	30	30	45	42	43	30	30	46	46	46	45	47	35	35	41	42	42	42	42	42	47	35	35	41	42	43	30	30	30	30	30	30	30	30	46	46	44	30	30	30	30	30	30	30	30	30	30	25	25	30	25	25	30	46	30	30	30	30	30	16	30	25	25	25	30	30	46	16	30	30	30	30	30	30	15	16	25	25	16	30	30	30	46	46	30	30	25	48	49	50	51	
35	30	30	30	30	25	25	25	30	30	30	30	30	25	25	30	30	30	30	30	36	36	36	30	35	35	35	35	30	30	30	30	30	35	35	35	35	30	30	30	30	30	30	30	30	30	30	36	36	30	25	25	25	25	25	25	25	30	30	30	30	30	30	30	30	30	36	30	25	25	25	30	16	25	25	15	15	30	30	36	16	30	25	25	25	25	25	16	16	15	15	16	25	25	30	36	36	36	25	15	37	38	39	40	
6	25	25	25	25	25	25	25	25	25	25	25	25	25	25	25	25	25	25	25	25	25	25	25	6	6	6	6	25	25	25	25	25	6	6	6	6	25	25	25	25	25	25	25	25	30	30	30	30	30	30	30	30	30	30	30	30	30	25	25	25	25	25	25	25	30	30	30	30	15	25	25	16	15	15	16	16	25	25	30	16	25	25	15	15	15	15	16	16	16	16	16	15	15	25	25	25	25	15	16	31	32	33	34	
6	22	23	24	22	24	22	22	23	23	23	24	22	23	23	24	24	22	23	23	22	23	23	24	6	1	6	6	22	23	23	23	24	6	6	6	6	22	23	23	23	23	24	25	25	25	25	25	25	25	25	25	25	25	25	25	25	25	25	15	15	15	15	15	25	25	25	25	25	16	15	15	16	16	16	16	16	15	25	25	16	15	15	16	16	16	16	16	16	16	16	16	16	16	15	15	15	15	16	16	26	27	28	29	
1	6	6	11	12	13	12	14	6	6	11	12	13	12	13	12	13	12	13	12	14	0	1	6	6	6	0	1	0	0	6	6	1	1	6	0	6	6	6	11	12	14	0	15	15	15	15	15	15	15	15	15	15	15	15	15	15	15	15	16	16	16	16	16	15	15	15	15	15	16	16	16	16	16	16	16	16	16	15	15	16	17	8	8	8	8	8	8	8	8	8	8	8	8	8	8	8	8	8	8	18	19	20	21	
0	1	0	2	3	4	3	5	0	1	2	3	4	3	4	3	4	3	4	3	5	6	0	6	0	1	6	0	1	1	6	0	6	6	6	1	0	6	1	2	3	5	1	7	8	8	8	8	8	8	8	8	8	8	8	8	8	8	8	8	8	8	8	8	8	8	8	8	8	8	8	8	8	8	8	8	8	8	8	8	8	9	9	9	9	9	9	9	9	9	9	9	9	9	9	9	9	9	9	10	6	6	6	6