6	44
64	64
0	0	0	0	1	2	3	0	4	0	5	0	6	0	0	7	0	8	9	2	0	0	0	0	0	0	0	10	0	0	11	0	0	12	12	13	6	14	15	16	16	16	16	16	
0	0	7	0	7	17	0	0	0	0	0	0	0	0	0	0	0	0	0	17	18	19	0	20	21	21	22	0	0	0	0	0	0	23	2	24	25	26	15	16	16	16	16	16	
0	0	0	0	0	0	0	0	0	0	0	0	0	0	0	0	0	0	0	0	27	28	29	30	31	31	32	0	0	0	0	0	0	0	0	33	0	0	15	16	16	16	16	16	
0	34	35	0	0	36	0	0	37	0	38	0	0	0	0	0	0	0	39	0	0	0	0	0	0	34	40	0	0	0	0	0	0	41	42	43	44	45	46	16	16	16	16	16	
47	48	0	49	50	51	52	53	54	55	0	56	57	58	59	60	0	0	0	0	61	62	63	64	0	65	65	0	66	67	68	69	0	70	71	72	73	74	75	16	76	77	78	79	
80	81	82	83	84	85	86	87	88	89	90	91	92	93	94	95	96	97	98	99	100	101	102	103	104	105	106	107	108	109	110	111	112	113	114	115	116	117	118	119	120	121	119	122	
