6	44
64	64
0	1	1	1	2	3	4	5	1	3	1	6	1	7	1	1	7	8	1	1	4	5	9	1	10	1	1	11	12	1	3	13	1	1	1	1	1	1	14	15	15	15	15	15	
16	17	17	17	18	19	20	21	22	23	24	17	25	17	17	26	17	27	28	29	17	17	17	17	17	17	17	30	17	17	31	17	17	32	32	33	25	34	35	15	15	15	15	15	
16	17	26	17	26	36	37	17	17	17	17	17	17	17	17	17	17	17	17	36	38	39	17	40	41	41	42	17	17	17	17	17	17	17	19	43	17	44	35	15	15	15	15	15	
16	17	17	17	17	17	17	17	17	17	17	17	17	17	17	17	17	17	17	17	17	17	45	46	47	47	48	17	17	17	17	17	17	17	17	49	17	17	35	15	15	15	15	15	
16	50	51	17	17	52	17	17	53	54	55	56	57	17	17	17	17	17	58	17	17	17	17	17	17	50	59	17	17	17	17	17	17	17	60	61	62	63	64	15	15	15	15	15	
65	66	17	67	68	69	70	71	72	73	17	74	75	76	77	78	17	17	17	17	79	80	81	82	83	84	84	17	17	85	86	87	88	89	90	91	17	92	93	15	94	95	96	97	
