11	0	1408	1408	1408
12	1408	1408	1408	1408
75	0	704	704	704
76	704	704	704	704
587	0	352	352	352	0	1	2	3	4	5	44	45	46	47	48	49	88	89	90	91	92	93
588	352	352	352	352	5	6	7	8	9	10	11	49	50	51	52	53	54	55	93	94	95	96	97	98	99
585	0	0	352	352	88	89	90	91	92	93	132	133	134	135	136	137	176	177	178	179	180	181	220	221	222	223	224	225
586	352	0	352	352	93	94	95	96	97	98	99	137	138	139	140	141	142	143	181	182	183	184	185	186	187	225	226	227	228	229	230	231
73	0	0	704	704
595	704	352	352	352	10	11	12	13	14	15	16	54	55	56	57	58	59	60	98	99	100	101	102	103	104
596	1056	352	352	352	16	17	18	19	20	21	22	60	61	62	63	64	65	66	104	105	106	107	108	109	110
593	704	0	352	352	98	99	100	101	102	103	104	142	143	144	145	146	147	148	186	187	188	189	190	191	192	230	231	232	233	234	235	236
594	1056	0	352	352	104	105	106	107	108	109	110	148	149	150	151	152	153	154	192	193	194	195	196	197	198	236	237	238	239	240	241	242
74	704	0	704	704
9	0	0	1408	1408
83	1408	704	704	704
84	2112	704	704	704
651	1408	352	352	352	21	22	23	24	25	26	27	65	66	67	68	69	70	71	109	110	111	112	113	114	115
652	1760	352	352	352	27	28	29	30	31	32	33	71	72	73	74	75	76	77	115	116	117	118	119	120	121
649	1408	0	352	352	109	110	111	112	113	114	115	153	154	155	156	157	158	159	197	198	199	200	201	202	203	241	242	243	244	245	246	247
650	1760	0	352	352	115	116	117	118	119	120	121	159	160	161	162	163	164	165	203	204	205	206	207	208	209	247	248	249	250	251	252	253
81	1408	0	704	704
659	2112	352	352	352	32	33	34	35	36	37	38	76	77	78	79	80	81	82	120	121	122	123	124	125	126
660	2464	352	352	352	38	39	40	41	42	43	82	83	84	85	86	87	126	127	128	129	130	131
657	2112	0	352	352	120	121	122	123	124	125	126	164	165	166	167	168	169	170	208	209	210	211	212	213	214	252	253	254	255	256	257	258
658	2464	0	352	352	126	127	128	129	130	131	170	171	172	173	174	175	214	215	216	217	218	219	258	259	260	261	262	263
82	2112	0	704	704
10	1408	0	1408	1408
1	0	0	2816	2816
