15	20
32	32
0	1	2	3	4	0	1	2	3	4	0	1	2	3	4	0	1	2	3	4	
5	5	5	5	5	5	6	7	8	9	10	11	12	13	5	5	14	15	16	5	
5	17	18	19	5	5	20	21	22	23	24	25	26	27	5	5	28	29	30	5	
5	31	32	33	34	35	36	37	38	39	40	41	42	43	5	44	45	5	5	5	
5	5	5	46	47	48	49	50	51	52	53	54	55	56	57	58	59	5	5	5	
60	61	5	62	63	64	65	66	67	68	69	70	71	72	73	74	75	5	76	77	
78	79	5	80	81	82	83	84	85	86	87	88	89	90	91	92	93	94	95	96	
5	5	5	5	5	5	5	5	97	98	99	100	5	5	5	5	5	101	102	103	
104	105	106	107	5	5	5	5	108	109	110	111	112	5	5	5	113	114	115	116	
117	118	119	120	5	5	121	122	123	124	125	126	127	128	129	5	130	131	132	133	
134	135	136	137	138	5	139	140	141	142	143	144	145	146	147	5	148	149	150	151	
152	153	154	155	156	5	157	158	159	160	161	162	163	164	165	166	167	168	169	170	
171	172	173	174	175	176	177	178	179	180	181	182	183	184	185	186	172	187	188	189	
190	191	192	193	194	195	191	192	193	194	195	191	192	193	194	195	191	192	193	196	
197	198	199	200	201	197	198	199	200	201	197	198	199	200	201	197	198	199	200	201	
